┌──────────────────────────────────────────────────────┐
│                                                      │
│                                                      │
│                                                      │
│                                                      │
└───────────────────────────────────────────┐          │
                                            │          │
                                            │          │
                 ┌───────┐                  │          │
                 │       └──────────────┐   │          │
                 │                    X │   │          │
                 │          ┌───────────┘   │          │
                 │          │               │          │
                 │          └───────────────┘          │
                 │                                     │
                 │                                     │
                 │                                     │
                 │                                     │
                 └─────────────────────────────────────┘