┌───────────────────────────────────────────────┐
│                                               │
│                                               │
│                                               │
│                                               │
│                                               │
│                                               │
│                                              X│
│                                               │
│                                               │
│                                               │
│                                               │
│                                               │
│                                               │
└───────────────────────────────────────────────┘